20 20
150 150
2 2 2 2 2 2 2 2 2 2 2 2 2 2 2 2 2 2 2 2 
2 2 2 2 2 2 2 2 2 2 2 2 2 2 2 2 2 2 2 2
2 2 1 1 1 1 1 1 1 1 1 1 1 1 1 1 1 1 2 2
2 2 1 1 1 1 1 1 1 1 1 1 1 1 1 1 1 1 2 2
2 2 1 1 0 0 0 0 0 0 0 0 0 0 0 0 1 1 2 2
2 2 1 1 0 0 0 0 0 0 0 0 0 0 0 0 1 1 2 2
2 2 1 1 0 0 0 0 0 0 0 0 0 0 0 0 1 1 2 2
2 2 1 1 0 0 0 0 0 0 0 0 0 0 0 0 1 1 2 2
2 2 1 1 0 0 0 0 0 0 0 0 0 0 0 0 1 1 2 2
2 2 1 1 0 0 0 0 0 0 0 0 0 0 0 0 1 1 2 2
2 2 1 1 0 0 0 0 0 0 0 0 0 0 0 0 1 1 2 2
2 2 1 1 0 0 0 0 0 0 0 0 0 0 0 0 1 1 2 2
2 2 1 1 0 0 0 0 0 0 0 0 0 0 0 0 1 1 2 2
2 2 1 1 0 0 0 0 0 0 0 0 0 0 0 0 1 1 2 2
2 2 1 1 0 0 0 0 0 0 0 0 0 0 0 0 1 1 2 2
2 2 1 1 0 0 0 0 0 0 0 0 0 0 0 0 1 1 2 2
2 2 1 1 1 1 1 1 1 1 1 1 1 1 1 1 1 1 2 2
2 2 1 1 1 1 1 1 1 1 1 1 1 1 1 1 1 1 2 2
2 2 2 2 2 2 2 2 2 2 2 2 2 2 2 2 2 2 2 2 
2 2 2 2 2 2 2 2 2 2 2 2 2 2 2 2 2 2 2 2